%%%%%%%%%%%%%%%%%%%%
%P%%%%%%%%%%%%%%%%%%
% %                %
% % %%%%%%%%%%%%%% %
% % %GGGG        % %
% % %%%%%%%%%%%% % %
% % %%%%%%%%%%%% % %
% %              % %
% %%%%%%%%%%%%%%%% %
%                  %
%%%%%%%%%%%%%%%%%%%%
